Format zapisu etapów
Wysokosc_mapy Szerokosc_mapy
Czas
Pozycja_startowa_X Pozycja_startowa_Y
Liczba_grafik_na_mapie(N)
N linii w formacie: (ograniczenia bezwzgledne)
Lewo_X Prawo_X Dol_Y Gora_Y Typ_grafiki:
a - wieza_zamku_ze_sciana_w_tle
b - cegla
c - czarne_tlo(wejscie do zamku)
d - wieza_zamku_z_niebem_w_tle
e - okienko_w_zamku_lewe
f - okienko_w_zamku_prawe
g - flaga_na_zamku
h - chmurka_gorna_lewa
i - chmurka_gorna_srodek
j - chmurka_gorna_prawa
k - chmurka_dolna_lewa
l - chmurka_dolna_srodek
m - chmurka_dolna_prawa
n - trawa_lewa
o - trawa_srodek
p - klocek_staly(niezniszczalny) 
q - klocek_do_stukania
r - trawa_prawa
s - klocek_zniszczony(32x32 tlo)
t - platforma_zielona_lewa
u - platforma_zielona_srodek
v - platforma_zielona_prawa
w - platforma_zielona_korzen
x - niebieskie_tlo_jako_dziura_w_ktorej_sie_spada
y - klocek_do_stukania_z_moneta
z - luk_nad_wejsciem_do_zamku
Liczba_przeciwnikow_na_mapie(M)
M linii w formacie: (ograniczenia bezwzgledne, ale ruchu (poczatek+koniec)/2)
Lewo_X Prawo_X Dol_Y Gora_Y Ograniczenie_ruchu_lewe_X Ograniczenie_ruchu_prawe_X Typ_przeciwnika:
a - stworek goombas
b - zolwio-ptasior